XXXXXXXXXXXXXXXXXXXXXXXXXXXXXXXXXXXXXXXXXXXXXXXXXXXXXXXXXXXXXXX
X             X X X X X X X X X X X X X X X X X X X X X X X X X
X XXXXXXXXXXX X X X X X X X X X X X X X X X X X X X X X X X X X
X XS        X X X X X X X X X X X X X X X X X X X X X X X X X X
X XXXXXXXXX X X X X X X X X X X X X X X X X X X X X X X X X X X
X XXXXXXXXX X X X X X X X X X X X X X X X X X X X X X X X X X X
X XXXX      X X X X X X X X X X X X X X X X X X X X X X X X X X
X XXXX XXXX X X X X X X X X X X X X X X X X X X X X X X X X X X
X XXXX XXXX X X X X X X X X X X X X X X X X X X X X X X X X X X
X X    XXXXXX X X X X X X X X X X X X X X X X X X X X X X X X X
X X XXXXXXXXX X X X X X X X X X X X X X X X X X X X X X X X X X
X X XXXXXXXXX X X X X X X X X X X X X X X X X X X X X X X X X X
X X         X X X X X X X X X X X X X X X X X X X X X X X X X X
X XXXXXXXXX   X X X X X X X X X X X X X X X X X X X X X X X X X
XFXXXXXXXXXXXXXXXXXXXXXXXXXXXXXXXXXXXXXXXXXXXXXXXXXXXXXXXXXXXXX